0000000000000000000000000
0002111100011110011111110
0000000100010010010000010
0000000100010010010000010
0001111100010011110000010
0001000000010000000000010
0001111111110000000001110
0000000000000000000001000
0000000000000000000001000
0000000111111111111111000
0000000100000000000000000
0001111100000000000000000
0001000000000000000000000
0001111111111111111111300
0000000000000000000000000
