0000000000000000000000000
0000000000011211000000000
0000000011110001111000000
0000000010000000001000000
0000000010000000001000000
0000011110000000001111000
0000010000000000000001000
0000010000000000000001000
0011111111111111111111111
0010010000000100000001001
0010010000000100000001001
0010011110000100001111001
0010000010000100001000001
0010000111111311111100001
0011111100000000000111111
