0000000000000000000000000
0011111111111100000000000
0010000000000100000111200
0010000000000100000100100
0010000000000100000100100
0010000000000100111111100
0010000011111110100100000
0010000010000011100100000
0011000010000000000111110
0001000010000000000000010
0001000010000111100000010
0001000010000100100000010
0003111110000100100000010
0000000011111100111111110
0000000000000000000000000
